10255550240040
11005550240040
11630550240040
12630550240040
12130380240040
13255550240040
14005550240040